####################################################################################################
#.#...#.#.....#...........#.....#.....#.....#.......#.....#.#...........#.#.#.......#.....#.#...#.##
#.###.#.#.###.#.#.#######.#.#####.#.#.###.#.###.###.#####.#.#.#.###.#.###.#.###.#######.###.#.###.##
#...#.......#...#.......#.#.......#.#.#...#.......#.#...#.....#...#.#.....#.......#...#...........##
###.#.###########.#.#####.#####.###.#.###.#############.#.#.#####################.#.#############.##
#...#...#########.#...#...#.....#...#.....##..........#...#.#.##.......##.....#.....#..........##.##
###.#.#######################.#.#######.####..........###.###.##.......######.#.#####..........##.##
#.....#.#########.#.#.#.......#...#.....#.##..........###.###.##.......######.#.#####..........##.##
#.###.#.#########.#.#.#.#############.###.##...................................................##.##
#.#.....#########.#.....#...#########.###.##..........###.######.......############.#..........##.##
#.###.#.#########.#.###.#.####........................###.######.......############.#..........##.##
#.#...#.#########...#.....#.##.####.#.###.##..........#...#...##.......##.....#.#...#..........##.##
###.###.###############.###.##.####.#.###.##..........###.#.#######.#####.#.#.#.###.#..........##.##
#...#.......#.......#...#.#.##.####.#.#...##..........#...#.......#.#.....#.#...#.#.#..........##.##
###.###.###.#.#.#########.#.##.####.###.####..........#.#######.###.###.###.###.#.###..........##.##
#...#...#.....#.....#.....#.......#.#.....#############.....#...#.#...#.#...#...#...#############.##
#.#########.###.###.###.#.#.##.##.#######.###############.#.#.#.#.#.#.#.#.#######.#.#############.##
#.....#...#.#.#...#.....#.#.##.##.#.....#.#...#.#.#.#.....#...#.#.#.#.#.#.#.#.#...#.....#.........##
#.#.###.#.#.#.#.#########.####.####.#########.#.#.#.#.###.#######.#.#.#.#.#.#.#.#.###.###.#.#.###.##
#.#...#.#...#.#.#...#.......##.##...#...#...#.......#.#...#...#...#.#.#.#...#...#.#...#...#.#.#.#.##
#.#######.#.#.###.#.#.#####.##.##.#.###.#.###.#####.#######.#.###.#.###.#####.###.#########.###.#.##
#.#.#...#.#...#...#.#.#.#...##....#.#...#.........#.#.....#.#...#.......#...#...#.....#.........#.##
#.#.###.#.#####.#.#.#.#.######.######.###.#######.###.###.#.#######.#####.#.###.#.#.#.#.#####.######
#...#.#.....#...#.#.#.#.######.######...#.#.............#...#...#.#...#...#.#.#.#.#.#.#.#####.....##
###.#.###.###.###.#####.#..........##.#.#.###.#####.#####.#.###.#.#.#######.#.#.#.#.###.#######.#.##
#...#.#.......#.....#...#..........##.#.#.#.#.#.#...#...#.#...#...#.....#.#.....#.#.#...#####.#.#.##
#####.###.###.#########.#..........####.###.#.#.#.#.#.###.#.#.###.#.#####.#########.#.#######.###.##
#.#...#...#.#.....#.....#..........##...#.....#...#.#.#...#.#.#...........#.#...#.....#.#.#.......##
#.###.###.#.#####.#.#.###..........##.###.#########.#.#.#####.###.#.#######.###.#.###.#.#.###.######
#...#...#.......#...#.#.#..........##.#...#######.....#...#...#.#.#.#####.........#.#.....#...#...##
#.###.#########.#######.#..........##.#.###############.###.###.###.....###########.#.#####.###.####
#.....#######.........#.#..........##.#...#######.....#...#...#...#.....#.#.......#.#.#...........##
###.#.###############.#.#..........##.#.#.#######.#.#.###.###.#.###.....#.#####.###.#.#####.#.###.##
#...#.#######.........#.#..........##...#.#######.#.#.....#.......#.....#.....#...#.....#...#...#.##
#####.###########.#####.#############.###########.#####.#########.#.....###.#####.###.#####.########
#.#...#######.......#.#.#.#.............#.....#.....#.#.........#.###.###.#.........#.#...........##
#.###.#######.#.#.###.#.#.#.#.#.#.#.#######.#.#.#####.#########.#####.###.#.#####.###.#######.#.####
#.........#...#.#.#.#.......#.#.#.#.....#...#.#.#.....#.......#.......#.....#.....#.........#.#.#.##
#.#.#######.###.###.#####.#####.#.#####.#.###.###.###.#.#.#.#.#.###.#.###.#.#####.#.###########.#.##
#.#...#.#.#.#.#...#.#.#.....#...#.....#.#.#.#.....#.#...#.#.#.#...#.#.#.#.#...#.#.#...........#.#.##
###.###.#.###.###.#.#.#.###.###.###.###.###.###.###.###.#.###.###.#.#.#.#.#.#.#.###.#.#########.#.##
#...#.#.#.#.#...#.#...#.#.#.#...#.#...#.#.#.....#...#...#...#.#.#.#.#.#...#.#.....#.#.........#...##
###.#.#.#.#.#.#.#.###.#.#.#####.#.#.###.#.#####.###.###.###.#.#.#####.#.#.###.#.#####.#####.#####.##
#.#...#.....#.#.....#...#.#.....#.....#...#.....#...#.....#.#.......#.#.#.#.#.#.........#.#.#.....##
#.#.###.#######.#########.#.#########.#.#######.#.###########.#######.###.#.###.#######.#.#.###.####
#.....#.........#.....#.....#########.#...#.......#.........#...#####.###...#.....#...#.#.....#...##
#.#.#.#####.#.#######.#####.#########.#####.###############.#.#######.#####.#########.#.#.###.###.##
#.#.#...#...#...#.#.........#########.....#.##.......##.#...#.#.#####.###.....#.......#.#...#.#...##
#.#####.#.#.#.###.#######################.#.##.......##.#.#####.#####.###.#######.###########.###.##
#.#...#...#.#.....#.......#.#########.#...#.##.......##.#.#####.#####.###...#...#.#########.#...#.##
#.#.#.###.###.###########.#.#########.#####.##........................###.#####.#.#########.#.###.##
#...#.#...#.#.....#.........#########...#...##.......##.###.#.#.#########.....#...#########...#...##
###.#.#.###.#.#############.#########.#.#.####.......##.###.#.#.#########.###.#.###########.#.######
#.#.#.#...#.#.#.....#.....#.#.........#.#...##.......##...#.#.#.#########.#...#...#########.#.#...##
#.#.###.#.#.#.#.#########.#.#.#.#.###.###.#######.#######.#####.###########.#.###.###########.#.#.##
#...#...#.#.#.#...#.......#...#.#...#.#.......#.#.#...#.......#.#...#.#.....#.....#########.....#.##
#######.#.#.###.###.#.#############.#####.#####.#.#.#####.###.#.###.#.#######.#############.###.####
#...#.#.#.....#.#.#.#...#.#.....#.....#.....#.#.#.#.#.#...#.#.#.......#.....#.#...#.......#...#.#.##
###.#.#####.#.#.#.#.#####.#.###.###.#######.#.#.#.#.#.#.###.#####.###.#.###.#.#.#########.###.#.#.##
#.#...#...#.#.......#.#...#.#...#.........#...#.#.#.....#.....#.#...#.#...#.#...#.#.......#...#...##
#.#.###.###.###.#####.###.#####.#.#.###.###.###.#.#.###.#.###.#.#.###.###.###.###.#.###.############
#...........#...#...#.....#.#...#.#.#.....#.......#...#...#.....#.#.....#...#.#.#.....#.#...#.....##
###.#########.#####.###.###.###.###.#####.#.#####.#.###.#.###.#.#.#.#######.#.#.#####.###.#.#.######
..#.#.#######.....#.......#...#...#.#.....#.....#.#.#...#.#...#.#.#...#.#.#.......#.#.....#.......##
#.#.#.#.....#.#######.#.###.#####.#.#.#.#########.#######.###.#.#.#####.#.#######.#.#.#####.###.####
#.#.#.#.....#.#.......#.............#.#.#.##..........#...#...#.#.#...............#.....#.#...#...##
#.#.#.#.....#######.#########.###.#####.#.##..........#.###.#############.#######.###.###.#.#.#.####
#.....#.....#...#.#...#.#.#.#.#.#.#.......##..........#...#...#.#########...#.#.#.......#...#.#...##
#.#####.....#.#.#.###.#.#.#.###.#####.######..........#########.#############.#.#.#.#############.##
#.....###.###.#...#.........#.....#.#...#.##..........#.....#...#########.........#...###########.##
#####.###.#######.#.#.#######.#####.#.###.##..........#.#####.###########.#######.###############.##
#...#.........#.#...#.#.#.......#...#.....##..........#.#.......#########...#.....#...###########.##
###.###.#.#####.###.###.#####.#.###.#.#.#.##..........#.#.#.###.#################.###.###########.##
#.......#...#.....#...#.#...#.#...#...#.#.##..........#...#.#...#########.#.......#...###########.##
###.#####.#######.#.#.#.#.#####.###.###.#.##..........#####.#############.#####.#####.###########.##
#.....#.#...#.#.#...#.....#.....#...#.#.#.#######.#####.....#...#########.......#.....###########.##
#.#####.#.###.#.#.#.###.###.#########.###.#######.#######.#.#.###########.#####.###.#############.##
#...#.#.#...#...#.#...#.....#.#.#...#...#...#...#.....#...#.#.......#...#.....#...#.....#.#.#.#...##
#.###.#.#.###.#####.#####.###.#.#.#.#.#.#.#.#.#.#.#.#####.#####.###.###.###.#######.###.#.#.#.#.#.##
#...#...#.#.#.........#...#.......#.#.#.#.#...#.#.#...#.#.#...#...#.....#.....#.....#.......#.#.#.##
#.#.#.#.#.#.#####.#.#######.#.###.#####.###.#.#.#.#.###.#.#.###.###.#####.#.###.#####.#.#.###.#.#.##
#.#...#.#.......#.#...#.#...#.#.........#.#.#.#.#.#...............#.#.....#...#.....#.#.#.#.....#.##
#.#######.#####.###.#.#.#####.###.#######.#.###.#.###########.#####.#.###########.###########.#.####
#.#######.#####.....#.#.....#.#.#.....#.......#.#.........#.#...#.............#.....#...#.#...#...##
#.##..........###.#.#######.###.#.###.#.#########.#######.#.#.#######.#########.#####.#.#.###.###.##
#.##..........#.#.#.............#...#.#.#.##..........#.....#.##..#.........#.#.#.#...#...#...#...##
#.##..........#.#############.#.#.###.###.##..........##########..#.#.###.###.#.#.###.###.#######.##
#.##..........#...........#...#.#.#.....#.##..........#...#...###.#.#.#.....#.........#.....#.#...##
####..........#####.#.#.###########.#####.##..........#.#####.###.###.###.#.#####.###.#.#####.#.#.##
#.##..........#.#.#.#.#...#########.#####.##..........#.#####.###...#.#.#.#...#.#.#...#...#...#.#.##
#.##..........#.#.###.#####.......................................#.###.###.#.#.###.#.###.#.#.#.####
#.##..........#.#.......###.###.#########.##..........#.###########.......#.#.#.....#...#...#.....##
#.##..........#.#######.##..###.#########.##..........#.###########.#.###.#####.#########.#.########
#.##........................#...#.....#...##..........#.#...#...#...#.#.#.#.#.....#...#...#.......##
#.#################.#########.#.#.#####.#.##..........###.###.#.###.#.#.#.#.#####.#.#####.###.###.##
#.#.#.#.............#.#.......#...#.....#.#############.....#.#.#...#...#...#...#.......#...#.#.#.##
#.#.#.#######.###.###.#.#.#.###.#.#.#.#################.#.###.###########.#.#.###.#########.###.#.##
#...............#.#.....#.#...#.#.#.#...............#...#.................#.#.....#.............#.##
####################################################################################################
####################################################################################################