####################################################################################################
#               #                                                                                 ##
# # # # # # # ##### ### # # # # ### # # # ############# # # # # # # # # # # # # # # ########### # ##
#     #             #                     #############             #               ###########   ##
# # # # # # # ##### # # ########### # ### ##          # # # # # ### # # # ##### # # ##       ## # ##
#   #               #   #########         ##          #                 #   # #     ##       ##   ##
# # # # # # # # # # # ####     ## ### # # ##          # # # # # # # # # # # # # ### ##       ## # ##
#                       ##     ##         ##          #                             ##       ##   ##
# # # # # # # # # ### # ##                            # # # # # # # ### # # # # # # ##       ## # ##
#                     # ##     ##   #     ##                                                 ##   ##
# # # # # # # # # # # # ##     #### # ### ##          # # # # # # # ##### # # # # # ##       ## # ##
#                       #### ####         ##          #                             ###########   ##
# # # # # # # # # # # # #### ###### ### # ##          # # # ### # # # # # # # # # # ########### # ##
#                       #         #       ##          #             #             #               ##
# # # # # # # # # # # #####   # # # # # # ######## #### # # # # # # # # # # # # # # # # # # # # ####
#                                       #                             #                           ##
# # # # # # ### # # # # # #   # # # # # # # # # #   # # ### ### # # # # # # # # # # # # # # # # # ##
#                             #                               #                                   ##
# # # # # # # # # # # # # #   ### # # # # # # # #  ## ### # # # # # # # # # # # # # # # # # # # #   
#           #   #                                   #                                             ##
# # # # # # # # # ### # # #   # ##### # # # # ###   # # # # # # # # # # # # # # # # # # # # # # # ##
#                                     #                                             #             ##
# # ##### # # ####### # # #   # # # # # # # ###### ###### # # # # # # # # # # # # # # # # # # # # ##
#                     #               #     ###### ######                 #                       ##
# # # # # ### # # ##### # ##  # # # # # ### #          ## # # ### # ########### # # ### # # # # # ##
#                             #       #     #          ##         #   #               #           ##
# # ######### # # # ### # #   ##### # ### # #          ## # # ##### ### ### # ### # # # # # ### # ##
#   #       #                               #          ## #             #               # #       ##
# # #       # # # # # # # ##  # # # ### # # #          ## # ### # # # # # # # # # ### # # # ### # ##
#   #       #   # #       #     #         # #          ##         # #                 #       #   ##
# # #                         # # # # # ### #          ## # ### # # ######### # # # # # ### # # # ##
# # #       #                               #          ## #         #   #         # #             ##
# # #       # # # # ### # # # # ### # ### # #          ## # ### # # # # # # # # # # # # ### # # # ##
#   #       #                     #         #          ##     #             #             # #     ##
# # ######### ### # # # # # # # # # # # # # ############# # # # ### # # # # # # # # # ### # # # # ##
#           #         #                             #         #                                   ##
# # # # # # # # # # # # # # # # # # # # # # # # # # # # # # # # # # # # # # # # # ### # ### # ### ##
#     #                                                                     #                     ##
# # # # # ### # # # # # # # # # # # ### # # # # # # # # # # # # # # # # # # # # # # ### # # # # # ##
#                       # #                                                                       ##
# ### # # # # # # ### # # # # # # ### # # # ### # # # # # # ### # ### # # # ### # # # ### # # # # ##
#                                                           #                 #                   ##
# # # # # # # # # # # # # # # # # # # # # # # # # # # # # # # # # # # # ### # # # # # # # # # # # ##
#       #           #                                             # #   #   #                     ##
# # # ##### ### # # # # # # # # # # # # # # # # # # # # # # # # # # # # # # # # # # # # # # # # # ##
#   #     #           #                                 #                   #                     ##
# # # # # # # # # # # ##### ##### # # # # # # # # # # # # # # ### # # # # # ### # # # # # # # # # ##
#                   # ##### #####                               #   #       #                     ##
# ### # # # # ##### # ##       ## # # # # # # # # # # # # ### # # # # # # # # ##### # # # # # # # ##
#                     ##       ##                         #   #   # #     #   #   #               ##
# # # # # # ### ### # ##       ## # # # # # # # # # # # # ### # # # ##### # # ### # # # # # # # # ##
#                     ##       ##                           #   #   #     # # #                   ##
# # # # # # # # ### # ##       ## # # # # # # # # # # ### # # ### # # # ### # # # # # ### # # # # ##
#               # #   ##       ##         #           #       #       #   #     #       #         ##
# # # # ### ### # # # ##       ## # # # ### # # # # # # # # ### # ### # ####### # # # # # # # # # ##
#       #     #       ###### ####                                               #     #           ##
# ### # # ### ### # # ###### #### # ### # # # # ### # # # # # ### # # ### # # # # # # # # # # ### ##
#                 #                                                     #                         ##
# ### # # # # # # ### # # #   # # # # ### # # # # # # # ##### # # ### # ### # # # # # # # # # # # ##
#       #                 #         #                                                           # ##
# # # # # # # # # # ### # #   # # # # # # # ### # # # # # # # # # # # # ### # # ### # # # # ### # ##
#                                                                             # #                 ##
# # # # # # # # # # # # # #   # # # # # # # # # # # # ### # # # # # # # # # # # # # # ######### # ##
#                             #                                     # #     #   #     #########   ##
# ############# # # # #####   # # # # # # # # # # # # # # # # # # # # # # ### # ### # #       # # ##
# ##          #                                                   #                   #       #   ##
# ##          # ### ### #### ###### # # # # # # # # # ### # # # # # # ##### # # # ### #       # ####
# ##          #         #### ####                       #                 #   #       #       #   ##
# ##          # # ### # #       # ### # # # # # # # # # # ### # # ### ### ### # # # # #       ### ##
# ##          #         #       #                                 #   #               #       #   ##
# ##          # # # # # #       # # # # # # # ##### # # ### # # # ####### # # # # # ###       # # ##
# ##                                                                        #       # #### ####   ##
# ##          # ### # # #       # # # # ### # # # # # # ##### # # #   # ### # # # # # #### #### # ##
# ##          #         #       #         #                     # #   #       # #                 ##
# ##          # # # # # #       # # ####### # # # # ### # # # # # ## ## # # # # # # # # #  ## # # ##
# ######## ####         #########                   #                                 #           ##
# ######## #### # # # # ######### # # # # # # # # ### ####### # # #   # # # # # ##### # ##  # # # ##
#                                                             #                       #           ##
# # # # #   # # # # # # # # # # # # # # # # # # # # # # # # # # # ##  # ### # # # # # # #   # ### ##
#   #         #           # #                     #     # # #                               # #   ##
# # # # #   # # # # # # # # # # # # # # # # # # # # # # # # ### # #   # # # # # # # # # #   # ### ##
#               #         #             #           #                 #     #                   # ##
# # ###### ###### # # # # # # # # # # # # # # # ### # # # ##### ###   # # # # # # # # # #   # # # ##
#   ###### ###### #   #                     # # #   #                                             ##
# # #          ## # # # # ####### # # # # # # # # # # # ### # # #### #### # # # # # ###### #### # ##
# # #          ##                 #         #   #           #   ##     ##           ###### ####   ##
# # #          ## # # # # # # # # # # # # # # # # ### # # # ### ##     ## # # # # # ##       ## # ##
# # #          ##     #                                       # ##                           ## # ##
# # #          ## # # # # # # # # # # # # # # # # # # # ### # # ##     ## # # # # # ##       ## # ##
#   #          ##         # #                             # #   ##     ##           ##       ##   ##
# # #          ## ### # # # # # # # # # # # # # # # # ### # # # ######### # # # # # ##       ## # ##
#   #          ##                       #           # #     #     #                 ##       ##   ##
# # #          ## # ### # # # # # # # # # # # # # ### # ### # # # # # # # # # # # # ##       ## # ##
#   #          ##         #       #           #       # #                           ########### # ##
# # ############# ### # ### # # # ### # # # # # # # # # # # ### ##### # # ##### # # ########### # ##
#                   # #           # #                   # #   #       #           #             # ##
# # # # # # # # # # # # # ### # ### # # # # # # # ### # # # # ##### # # # # # # # # # # # # # # # ##
#                 # #   #                       #     #   #                                 #     ##
####################################################################################################
####################################################################################################